X X X X X X X X X X
X K R X X X X X X X
X R R X X X X X X X
X R R X X X X X X X
X R R R X X X X X X
X R R R X X X X X X
X R R R R R X X X X
X R R R R R R X X T
X R R R R R R R R R
X X X X X X X X X X